R 952 850
NO ./textures/colorstone.xpm
SO ./textures/eagle.xpm
EA ./textures/greystone.xpm


WE ./textures/redbrick.xpm
S ./textures/barrel.xpm
C 135,206,250


F 255,0,0
                                         11111
                                        11020111111111
11111111111111111                       11000000000001
100000000000000011111111111111111111111111020020020021
102000002000002000000000000000000000000000000000000001
100000000000000011111111111111111001111111111111011111
10002000200020001               1001           101
10000000000000001               1001           101111111111111111
10202020N02020201               1001           100000000000000001
10000000000000001           111110011111       111111111111111101
10002000200200001           100000000001                      101
10000000000000001           100000000001                      101
10200000200002001111111111111000200200011111111111111111111111101
10000000000000000000000000000000000000000000000000000000000000001
11111011111111111111111111111000200200011111111111111111111111101
    101                     100000000001                      101
11111011111111111           100000000001                      101
10000000000000001           111110011111                      101
10200000200000201               1001                          101
10000000000000001111111111111111100111111111111111111111111111101
10002000200020000000000000000000000000000000000000000000000000001
10000000000000001111111111111111111111111111111111111111111111111
10202020002020201
10000000000000001
10002000200200001
10000000000000001
10200000200002001
10000000000000001
11111111111111111
