R 1200 880
NO ./textures/eagle.xpm
SO ./textures/eagle.xpm
EA ./textures/eagle.xpm


WE ./textures/eagle.xpm
S ./textures/purplestone.xpm
C 255,200,160


F 122,122,122
111111111111111
1N0000000000101
100001000000101
111100000010101
100000000010101
100000001111101
100000000000001
100000000000001
111111000111101
100000000000001
111111111111111



