R 952 850
NO ./textures/eagle.xpm
SO ./textures/eagle.xpm
EA ./textures/eagle.xpm


WE ./textures/eagle.xpm
S ./textures/purplestone.xpm
C 135,206,250


F 255,0,0
1111111111111111111111
1000000000001011111111
1000010000001011111111
10000E0000101011111111
1000000000101011111111
1000000011111011111111
1000000000000011111111
1000000000000011111111
1111110001111011111111
1000000000000011111111
1111111111111111111111
1111111
1111111
1111111111111111111111


